1111111111111111111111111121111111111111
1000001000000000000000000100010000100001
1001001000001000000110110101010010001003
1001001000011000000100010001010011111111
1001011111110010111100011111110000000001
1001000000000010000100001000000001011101
1001111110111111110100001000001001000101
1000000000000010000100001111111111111101
1001001111000010000000001000000000000001
1001001001000011111110111011111111111111
1001001001111000000010100000000000000001
1001000001001000000010100011111101000001
1001110111000000000010100010000001000001
1000000001001111100010100010000001000001
1001000001001000100010111111110111111111
1001111101101000100000100000010000100001
1001000000111000111110100000011110111101
1001000000000000000010111110000010000001
1001000000000000101010100010010011111011
1001111111111000101010101010010000001001
1001000000001000101010101011110111111001
1000000111111000101110101010000000001001
1001000100000000100000101010000011111001
1001111110111011111111101010000010100001
1001000010100010000000001010000010100001
1001001011101010110111111110000010111101
1001001000001010100001000000111110000001
1001111111111110100101000011100000010011
1000000000000000100100000000000001010001
1111111111111111111111111111111111111111
